R 1080 720
NO srcs/lavaboy.xpm
SO srcs/bloque.xpm
WE srcs/puerta.xpm
EA srcs/flor.xpm
S srcs/barril.xpm

C 42,42,42
F 1,23,21
                                          11111111111111111
 11111111             111111              10000000000000001
 10000001             101001   111        10111100000111101
 11100011    1111     1010001110001       101     0     101
 10200001   100201    1000000000201       101     2     101   111111111111111111
 10001111   100001    1000011100001       11111111111111111   110000000000000001
 100000201110001001111 1201   1001        101           101   110000000000000001
  1110000   00010000001000011100011       101           101   110000000000000001
 1000200100002010001000000001000111       101           101   110111111111111111
  1100001000011100010100111100010001      101           10111111011
    1001 1001   10010011   100110111111111101           10000000011
    1001 0201    10001     100000000000000001           11111111111
    100S00001     111       11111111111111111                 1111
    100000001                                                 1111
 111111001111
 100000000001
 122222222221
 111111111111