R 6000 6000
NO srcs/lavaboy.xpm
SO srcs/bloque.xpm
WE srcs/puerta.xpm
EA srcs/flor.xpm

S srcs/barril.xpm
F 71,75,78
C 205,92,205

        11111111111111
      110000000000000011
  11110000000000000000001111
  111100000000 N 00000001111
  11110000000000000000001111
  11110000000000000000001111
      110000000000000011
        11111111111111