R 6000 6000
NO srcs/lavaboy.xpm
SO srcs/bloque.xpm
WE srcs/puerta.xpm
EA srcs/flor.xpm

S srcs/barril.xpm
F 0,0,15
C 30,92,35

11111111111
10000000101
10000010101
1000N000001
11110111001
11111111111