R 1800 1000
NO srcs/lavaboy.xpm
SO srcs/bloque.xpm
WE srcs/puerta.xpm
EA srcs/flor.xpm
S srcs/miguelito.xpm
C 10,10,10
F 40,40,42

                                         11111111111111111
11111111              11111              10000000000000011
10000001             101001   111        10111100000111101
 1110001    1111     1010001110001       101           101
10200001   100201    1000000000201       101           101    11111111111111111
10001111   100001    1000011100001       10111111  1111101    12000000000000001
100000201110001001111 1201   1001        101    1  1   101    100000000000000W1
 1110000   0001000000100001110001        101    1  1   101    10000000000000001
1000200100002010001000000001000111       101    1221   101    10111111111111111
 110000100001110010100111100010001       101    1111   10111111011
   1001 1001   1001001    100110111111111101           10020000011
   1001 1201    10001     100000000000000001           11111111111
   100010001     111       11111111111111111                 1111
   100000001                                                 1111
    1111111