R 1800 1000
SO srcs/bloque.xpm
NO srcs/lavaboy.xpm
EA srcs/flor.xpm
WE srcs/puerta.xpm
S srcs/miguelito.xpm
C 42,42,42
F 34,30,30

                                         11111111111111111
11111111              11111              10000000000000011
10000001             101001   111        10111100000111101
 1110001    1111     1010001110001       10100000000000101
10200001   100201    1000000000201       10100000000000101    11111111111111111
10001111   100001    1000011100001       10111111001111101    10000000000000001
100000201110001001111 1201   1001        101    1001   101    120000000000000N1
 1110000   0001000000100001110001        101    1001   101    10000000000000001
1000200100002010001000000001000111       101    1221   101    10111111111111111
 110000100001110010100111100010001       101    1111   10111111011
   1001 1001   1001001    100110111111111101           10020000011
   1001 1201    10001     100000000000000001           11111111111
   100010001     111       11111111111111111                 1111
   100000001                                                 1111
    1111111