R 6000 6000
NO srcs/lavaboy.xpm
SO srcs/bloque.xpm
WE srcs/puerta.xpm
EA srcs/flor.xpm

S srcs/barril.xpm
F 0,0,15
C 30,92,35

       111111111111111111
       110000000000000011
   11110000000000000000001111
   111100000000 N 00000001111
   11110000000000000000001111
   11110000000000000000001111
       110000000000000011
       111111111111111111