R 1080 500

NO srcs/lavaboy.xpm
SO srcs/bloque.xpm
WE srcs/puerta.xpm
EA srcs/flor.xpm

S srcs/barril.xpm
F 141,25,37
C 00,153,164

                                         11111111111111111
 111111               1 11               100000000S0000001
10000001             101001   111        10111111111111101
 1110001    1111     1010001110001       101           101
10200001   100201    1000000000201       101           101   111111111111111111
10001111   100001    1000011100001       10111111111111101   111000000000000001
100000201110001001111 1201   1001        101           101   111000000000000001
 1110000   0001000000100001110001        101           101   111000000000000001
100020010000201000100002000010001        101           101   111111111111111111
 110000100001110010100111100010001       101           10111111111
   1001 1001   1001001    100110111111111101           11111111111
   1001 1201    10001     100000000000000001                 1111
   100010001     111       11111111111111111                 1111
   100000001                                                 1111
    1111111
